,trace,debug,info,warn,error,fatal,
IfBlock,1891,5440,3213,2063,1251,10,13868
ForBlock,51,207,664,21,32,0,975
DoBlock,4,2,4,0,0,0,10
WhileBlock,19,57,201,7,5,0,289
TryBlock,136,330,1164,39,27,0,1696
CatchBlock,0,437,632,1537,2482,4,5092
SwitchBlock,13,44,132,57,34,4,284
MethodBlock,614,1573,6736,455,547,26,9951
SynchronizedBlock,9,21,28,1,2,0,61
ClassBlock,35,107,163,8,17,3,333
,2772,8218,12937,4188,4397,47,32559
